"filename", "language", "Java", "comment", "blank", "total"
"c:\Users\Povilas.Grusas\OneDrive - Bentley Systems, Inc\Desktop\Bakis repo\voiceControlledRuleEditor\org.openhab.binding.voicecontrolledruleeditor\src\main\java\org\openhab\binding\voicecontrolledruleeditor\internal\VoiceControlledRuleEditorHandler.java", "Java", 6, 0, 0, 6
"c:\Users\Povilas.Grusas\OneDrive - Bentley Systems, Inc\Desktop\Bakis repo\voiceControlledRuleEditor\org.openhab.binding.voicecontrolledruleeditor\src\main\java\org\openhab\binding\voicecontrolledruleeditor\internal\assistant\Instructions.java", "Java", 0, 1, 0, 1
"c:\Users\Povilas.Grusas\OneDrive - Bentley Systems, Inc\Desktop\Bakis repo\voiceControlledRuleEditor\org.openhab.binding.voicecontrolledruleeditor\src\main\java\org\openhab\binding\voicecontrolledruleeditor\internal\assistant\StatusReport.java", "Java", 21, 0, 6, 27
"c:\Users\Povilas.Grusas\OneDrive - Bentley Systems, Inc\Desktop\Bakis repo\voiceControlledRuleEditor\org.openhab.binding.voicecontrolledruleeditor\src\main\java\org\openhab\binding\voicecontrolledruleeditor\internal\commandHandlers\DefaultController.java", "Java", 99, 1, 25, 125
"c:\Users\Povilas.Grusas\OneDrive - Bentley Systems, Inc\Desktop\Bakis repo\voiceControlledRuleEditor\org.openhab.binding.voicecontrolledruleeditor\src\main\java\org\openhab\binding\voicecontrolledruleeditor\internal\commandHandlers\ruleExternals\RuleAddingHandler.java", "Java", 1, 2, 0, 3
"c:\Users\Povilas.Grusas\OneDrive - Bentley Systems, Inc\Desktop\Bakis repo\voiceControlledRuleEditor\org.openhab.binding.voicecontrolledruleeditor\src\main\java\org\openhab\binding\voicecontrolledruleeditor\internal\commandHandlers\ruleExternals\RuleDeletingHandler.java", "Java", 64, -2, 16, 78
"c:\Users\Povilas.Grusas\OneDrive - Bentley Systems, Inc\Desktop\Bakis repo\voiceControlledRuleEditor\org.openhab.binding.voicecontrolledruleeditor\src\main\java\org\openhab\binding\voicecontrolledruleeditor\internal\commandHandlers\ruleExternals\RuleRenamingHandler.java", "Java", 1, 2, 0, 3
"c:\Users\Povilas.Grusas\OneDrive - Bentley Systems, Inc\Desktop\Bakis repo\voiceControlledRuleEditor\org.openhab.binding.voicecontrolledruleeditor\src\main\java\org\openhab\binding\voicecontrolledruleeditor\internal\commandHandlers\ruleInternals\RuleConditionBuilder.java", "Java", 0, 1, 0, 1
"c:\Users\Povilas.Grusas\OneDrive - Bentley Systems, Inc\Desktop\Bakis repo\voiceControlledRuleEditor\org.openhab.binding.voicecontrolledruleeditor\src\main\java\org\openhab\binding\voicecontrolledruleeditor\internal\commandHandlers\ruleInternals\RuleEditingController.java", "Java", 1, -1, 0, 0
"c:\Users\Povilas.Grusas\OneDrive - Bentley Systems, Inc\Desktop\Bakis repo\voiceControlledRuleEditor\org.openhab.binding.voicecontrolledruleeditor\src\main\java\org\openhab\binding\voicecontrolledruleeditor\internal\commandHandlers\states\ruleDelete\RuleDeleteWaitingForNameConfirmationState.java", "Java", 30, 0, 9, 39
"c:\Users\Povilas.Grusas\OneDrive - Bentley Systems, Inc\Desktop\Bakis repo\voiceControlledRuleEditor\org.openhab.binding.voicecontrolledruleeditor\src\main\java\org\openhab\binding\voicecontrolledruleeditor\internal\commandHandlers\states\ruleDelete\RuleDeleteWaitingForNameState.java", "Java", 30, 0, 9, 39
"c:\Users\Povilas.Grusas\OneDrive - Bentley Systems, Inc\Desktop\Bakis repo\voiceControlledRuleEditor\org.openhab.binding.voicecontrolledruleeditor\src\main\java\org\openhab\binding\voicecontrolledruleeditor\internal\constants\TTSConstants.java", "Java", 14, 0, 0, 14
"c:\Users\Povilas.Grusas\OneDrive - Bentley Systems, Inc\Desktop\Bakis repo\voiceControlledRuleEditor\org.openhab.binding.voicecontrolledruleeditor\src\main\java\org\openhab\binding\voicecontrolledruleeditor\internal\constants\UserInputs.java", "Java", 2, 0, 1, 3
"c:\Users\Povilas.Grusas\OneDrive - Bentley Systems, Inc\Desktop\Bakis repo\voiceControlledRuleEditor\org.openhab.binding.voicecontrolledruleeditor\src\main\java\org\openhab\binding\voicecontrolledruleeditor\internal\factory\VoiceControlledRuleEditorHandlerFactory.java", "Java", 4, 0, 0, 4
"c:\Users\Povilas.Grusas\OneDrive - Bentley Systems, Inc\Desktop\Bakis repo\voiceControlledRuleEditor\org.openhab.binding.voicecontrolledruleeditor\src\main\java\org\openhab\binding\voicecontrolledruleeditor\internal\utils\RuleManagerUtils.java", "Java", 25, 0, 9, 34
"c:\Users\Povilas.Grusas\OneDrive - Bentley Systems, Inc\Desktop\Bakis repo\voiceControlledRuleEditor\org.openhab.binding.voicecontrolledruleeditor\src\main\java\org\openhab\binding\voicecontrolledruleeditor\internal\utils\RuleRegistryUtils.java", "Java", 9, 1, 2, 12
"Total", "-", 307, 5, 77, 389