"filename", "language", "Java", "comment", "blank", "total"
"c:\Users\Povilas.Grusas\OneDrive - Bentley Systems, Inc\Desktop\Bakis repo\voiceControlledRuleEditor\org.openhab.binding.voicecontrolledruleeditor\src\main\java\org\openhab\binding\voicecontrolledruleeditor\internal\UserInformation.java", "Java", 28, 0, 10, 38
"c:\Users\Povilas.Grusas\OneDrive - Bentley Systems, Inc\Desktop\Bakis repo\voiceControlledRuleEditor\org.openhab.binding.voicecontrolledruleeditor\src\main\java\org\openhab\binding\voicecontrolledruleeditor\internal\VoiceControlledRuleEditorBindingConstants.java", "Java", 9, 20, 6, 35
"c:\Users\Povilas.Grusas\OneDrive - Bentley Systems, Inc\Desktop\Bakis repo\voiceControlledRuleEditor\org.openhab.binding.voicecontrolledruleeditor\src\main\java\org\openhab\binding\voicecontrolledruleeditor\internal\VoiceControlledRuleEditorConfiguration.java", "Java", 8, 20, 4, 32
"c:\Users\Povilas.Grusas\OneDrive - Bentley Systems, Inc\Desktop\Bakis repo\voiceControlledRuleEditor\org.openhab.binding.voicecontrolledruleeditor\src\main\java\org\openhab\binding\voicecontrolledruleeditor\internal\VoiceControlledRuleEditorHandler.java", "Java", 84, 49, 21, 154
"c:\Users\Povilas.Grusas\OneDrive - Bentley Systems, Inc\Desktop\Bakis repo\voiceControlledRuleEditor\org.openhab.binding.voicecontrolledruleeditor\src\main\java\org\openhab\binding\voicecontrolledruleeditor\internal\assistant\Instructions.java", "Java", 96, 1, 20, 117
"c:\Users\Povilas.Grusas\OneDrive - Bentley Systems, Inc\Desktop\Bakis repo\voiceControlledRuleEditor\org.openhab.binding.voicecontrolledruleeditor\src\main\java\org\openhab\binding\voicecontrolledruleeditor\internal\assistant\StatusReport.java", "Java", 72, 0, 23, 95
"c:\Users\Povilas.Grusas\OneDrive - Bentley Systems, Inc\Desktop\Bakis repo\voiceControlledRuleEditor\org.openhab.binding.voicecontrolledruleeditor\src\main\java\org\openhab\binding\voicecontrolledruleeditor\internal\commandHandlers\DefaultController.java", "Java", 130, 1, 35, 166
"c:\Users\Povilas.Grusas\OneDrive - Bentley Systems, Inc\Desktop\Bakis repo\voiceControlledRuleEditor\org.openhab.binding.voicecontrolledruleeditor\src\main\java\org\openhab\binding\voicecontrolledruleeditor\internal\commandHandlers\HandleCommandResult.java", "Java", 19, 0, 7, 26
"c:\Users\Povilas.Grusas\OneDrive - Bentley Systems, Inc\Desktop\Bakis repo\voiceControlledRuleEditor\org.openhab.binding.voicecontrolledruleeditor\src\main\java\org\openhab\binding\voicecontrolledruleeditor\internal\commandHandlers\ICommandHandler.java", "Java", 4, 0, 2, 6
"c:\Users\Povilas.Grusas\OneDrive - Bentley Systems, Inc\Desktop\Bakis repo\voiceControlledRuleEditor\org.openhab.binding.voicecontrolledruleeditor\src\main\java\org\openhab\binding\voicecontrolledruleeditor\internal\commandHandlers\RuleReaderController.java", "Java", 3, 0, 3, 6
"c:\Users\Povilas.Grusas\OneDrive - Bentley Systems, Inc\Desktop\Bakis repo\voiceControlledRuleEditor\org.openhab.binding.voicecontrolledruleeditor\src\main\java\org\openhab\binding\voicecontrolledruleeditor\internal\commandHandlers\UsersCommandHandler.java", "Java", 53, 0, 14, 67
"c:\Users\Povilas.Grusas\OneDrive - Bentley Systems, Inc\Desktop\Bakis repo\voiceControlledRuleEditor\org.openhab.binding.voicecontrolledruleeditor\src\main\java\org\openhab\binding\voicecontrolledruleeditor\internal\commandHandlers\ruleExternals\RuleAddingHandler.java", "Java", 103, 2, 31, 136
"c:\Users\Povilas.Grusas\OneDrive - Bentley Systems, Inc\Desktop\Bakis repo\voiceControlledRuleEditor\org.openhab.binding.voicecontrolledruleeditor\src\main\java\org\openhab\binding\voicecontrolledruleeditor\internal\commandHandlers\ruleExternals\RuleDeletingHandler.java", "Java", 73, 0, 20, 93
"c:\Users\Povilas.Grusas\OneDrive - Bentley Systems, Inc\Desktop\Bakis repo\voiceControlledRuleEditor\org.openhab.binding.voicecontrolledruleeditor\src\main\java\org\openhab\binding\voicecontrolledruleeditor\internal\commandHandlers\ruleExternals\RuleRenamingHandler.java", "Java", 97, 2, 26, 125
"c:\Users\Povilas.Grusas\OneDrive - Bentley Systems, Inc\Desktop\Bakis repo\voiceControlledRuleEditor\org.openhab.binding.voicecontrolledruleeditor\src\main\java\org\openhab\binding\voicecontrolledruleeditor\internal\commandHandlers\ruleInternals\AbstractModuleBuilder.java", "Java", 99, 2, 33, 134
"c:\Users\Povilas.Grusas\OneDrive - Bentley Systems, Inc\Desktop\Bakis repo\voiceControlledRuleEditor\org.openhab.binding.voicecontrolledruleeditor\src\main\java\org\openhab\binding\voicecontrolledruleeditor\internal\commandHandlers\ruleInternals\AvailableConfigurationType.java", "Java", 18, 0, 5, 23
"c:\Users\Povilas.Grusas\OneDrive - Bentley Systems, Inc\Desktop\Bakis repo\voiceControlledRuleEditor\org.openhab.binding.voicecontrolledruleeditor\src\main\java\org\openhab\binding\voicecontrolledruleeditor\internal\commandHandlers\ruleInternals\IBuilder.java", "Java", 14, 1, 10, 25
"c:\Users\Povilas.Grusas\OneDrive - Bentley Systems, Inc\Desktop\Bakis repo\voiceControlledRuleEditor\org.openhab.binding.voicecontrolledruleeditor\src\main\java\org\openhab\binding\voicecontrolledruleeditor\internal\commandHandlers\ruleInternals\RuleActionBuilder.java", "Java", 108, 3, 11, 122
"c:\Users\Povilas.Grusas\OneDrive - Bentley Systems, Inc\Desktop\Bakis repo\voiceControlledRuleEditor\org.openhab.binding.voicecontrolledruleeditor\src\main\java\org\openhab\binding\voicecontrolledruleeditor\internal\commandHandlers\ruleInternals\RuleConditionBuilder.java", "Java", 82, 1, 11, 94
"c:\Users\Povilas.Grusas\OneDrive - Bentley Systems, Inc\Desktop\Bakis repo\voiceControlledRuleEditor\org.openhab.binding.voicecontrolledruleeditor\src\main\java\org\openhab\binding\voicecontrolledruleeditor\internal\commandHandlers\ruleInternals\RuleEditingController.java", "Java", 308, 0, 73, 381
"c:\Users\Povilas.Grusas\OneDrive - Bentley Systems, Inc\Desktop\Bakis repo\voiceControlledRuleEditor\org.openhab.binding.voicecontrolledruleeditor\src\main\java\org\openhab\binding\voicecontrolledruleeditor\internal\commandHandlers\ruleInternals\RuleTriggerBuilderHandler.java", "Java", 110, 6, 10, 126
"c:\Users\Povilas.Grusas\OneDrive - Bentley Systems, Inc\Desktop\Bakis repo\voiceControlledRuleEditor\org.openhab.binding.voicecontrolledruleeditor\src\main\java\org\openhab\binding\voicecontrolledruleeditor\internal\commandHandlers\states\AbstractHandlerState.java", "Java", 30, 2, 10, 42
"c:\Users\Povilas.Grusas\OneDrive - Bentley Systems, Inc\Desktop\Bakis repo\voiceControlledRuleEditor\org.openhab.binding.voicecontrolledruleeditor\src\main\java\org\openhab\binding\voicecontrolledruleeditor\internal\commandHandlers\states\ruleAdd\RuleAddWaitingForEditConfirmation.java", "Java", 30, 0, 9, 39
"c:\Users\Povilas.Grusas\OneDrive - Bentley Systems, Inc\Desktop\Bakis repo\voiceControlledRuleEditor\org.openhab.binding.voicecontrolledruleeditor\src\main\java\org\openhab\binding\voicecontrolledruleeditor\internal\commandHandlers\states\ruleAdd\RuleAddWaitingForNameConfirmationState.java", "Java", 30, 0, 9, 39
"c:\Users\Povilas.Grusas\OneDrive - Bentley Systems, Inc\Desktop\Bakis repo\voiceControlledRuleEditor\org.openhab.binding.voicecontrolledruleeditor\src\main\java\org\openhab\binding\voicecontrolledruleeditor\internal\commandHandlers\states\ruleAdd\RuleAddWaitingForNameState.java", "Java", 30, 0, 9, 39
"c:\Users\Povilas.Grusas\OneDrive - Bentley Systems, Inc\Desktop\Bakis repo\voiceControlledRuleEditor\org.openhab.binding.voicecontrolledruleeditor\src\main\java\org\openhab\binding\voicecontrolledruleeditor\internal\commandHandlers\states\ruleDelete\RuleDeleteWaitingForNameConfirmationState.java", "Java", 30, 0, 9, 39
"c:\Users\Povilas.Grusas\OneDrive - Bentley Systems, Inc\Desktop\Bakis repo\voiceControlledRuleEditor\org.openhab.binding.voicecontrolledruleeditor\src\main\java\org\openhab\binding\voicecontrolledruleeditor\internal\commandHandlers\states\ruleDelete\RuleDeleteWaitingForNameState.java", "Java", 30, 0, 9, 39
"c:\Users\Povilas.Grusas\OneDrive - Bentley Systems, Inc\Desktop\Bakis repo\voiceControlledRuleEditor\org.openhab.binding.voicecontrolledruleeditor\src\main\java\org\openhab\binding\voicecontrolledruleeditor\internal\commandHandlers\states\ruleEdit\RuleEditCreateModuleState.java", "Java", 30, 0, 9, 39
"c:\Users\Povilas.Grusas\OneDrive - Bentley Systems, Inc\Desktop\Bakis repo\voiceControlledRuleEditor\org.openhab.binding.voicecontrolledruleeditor\src\main\java\org\openhab\binding\voicecontrolledruleeditor\internal\commandHandlers\states\ruleEdit\RuleEditEditModuleState.java", "Java", 30, 0, 9, 39
"c:\Users\Povilas.Grusas\OneDrive - Bentley Systems, Inc\Desktop\Bakis repo\voiceControlledRuleEditor\org.openhab.binding.voicecontrolledruleeditor\src\main\java\org\openhab\binding\voicecontrolledruleeditor\internal\commandHandlers\states\ruleEdit\RuleEditRemoveModuleState.java", "Java", 30, 0, 9, 39
"c:\Users\Povilas.Grusas\OneDrive - Bentley Systems, Inc\Desktop\Bakis repo\voiceControlledRuleEditor\org.openhab.binding.voicecontrolledruleeditor\src\main\java\org\openhab\binding\voicecontrolledruleeditor\internal\commandHandlers\states\ruleEdit\RuleEditWaitingForEditTypeState.java", "Java", 30, 0, 9, 39
"c:\Users\Povilas.Grusas\OneDrive - Bentley Systems, Inc\Desktop\Bakis repo\voiceControlledRuleEditor\org.openhab.binding.voicecontrolledruleeditor\src\main\java\org\openhab\binding\voicecontrolledruleeditor\internal\commandHandlers\states\ruleEdit\RuleEditWaitingForNameState.java", "Java", 30, 0, 9, 39
"c:\Users\Povilas.Grusas\OneDrive - Bentley Systems, Inc\Desktop\Bakis repo\voiceControlledRuleEditor\org.openhab.binding.voicecontrolledruleeditor\src\main\java\org\openhab\binding\voicecontrolledruleeditor\internal\commandHandlers\states\ruleRename\RuleRenameWaitingForNameConfirmationState.java", "Java", 30, 0, 9, 39
"c:\Users\Povilas.Grusas\OneDrive - Bentley Systems, Inc\Desktop\Bakis repo\voiceControlledRuleEditor\org.openhab.binding.voicecontrolledruleeditor\src\main\java\org\openhab\binding\voicecontrolledruleeditor\internal\commandHandlers\states\ruleRename\RuleRenameWaitingForNewNameState.java", "Java", 30, 0, 9, 39
"c:\Users\Povilas.Grusas\OneDrive - Bentley Systems, Inc\Desktop\Bakis repo\voiceControlledRuleEditor\org.openhab.binding.voicecontrolledruleeditor\src\main\java\org\openhab\binding\voicecontrolledruleeditor\internal\commandHandlers\states\ruleRename\RuleRenameWaitingForOldNameState.java", "Java", 30, 0, 9, 39
"c:\Users\Povilas.Grusas\OneDrive - Bentley Systems, Inc\Desktop\Bakis repo\voiceControlledRuleEditor\org.openhab.binding.voicecontrolledruleeditor\src\main\java\org\openhab\binding\voicecontrolledruleeditor\internal\constants\Enums.java", "Java", 164, 0, 27, 191
"c:\Users\Povilas.Grusas\OneDrive - Bentley Systems, Inc\Desktop\Bakis repo\voiceControlledRuleEditor\org.openhab.binding.voicecontrolledruleeditor\src\main\java\org\openhab\binding\voicecontrolledruleeditor\internal\constants\ModuleTypes.java", "Java", 12, 0, 2, 14
"c:\Users\Povilas.Grusas\OneDrive - Bentley Systems, Inc\Desktop\Bakis repo\voiceControlledRuleEditor\org.openhab.binding.voicecontrolledruleeditor\src\main\java\org\openhab\binding\voicecontrolledruleeditor\internal\constants\TTSConstants.java", "Java", 74, 2, 10, 86
"c:\Users\Povilas.Grusas\OneDrive - Bentley Systems, Inc\Desktop\Bakis repo\voiceControlledRuleEditor\org.openhab.binding.voicecontrolledruleeditor\src\main\java\org\openhab\binding\voicecontrolledruleeditor\internal\constants\UserInputs.java", "Java", 106, 18, 21, 145
"c:\Users\Povilas.Grusas\OneDrive - Bentley Systems, Inc\Desktop\Bakis repo\voiceControlledRuleEditor\org.openhab.binding.voicecontrolledruleeditor\src\main\java\org\openhab\binding\voicecontrolledruleeditor\internal\factory\VoiceControlledRuleEditorHandlerFactory.java", "Java", 56, 18, 11, 85
"c:\Users\Povilas.Grusas\OneDrive - Bentley Systems, Inc\Desktop\Bakis repo\voiceControlledRuleEditor\org.openhab.binding.voicecontrolledruleeditor\src\main\java\org\openhab\binding\voicecontrolledruleeditor\internal\utils\AudioManagerUtils.java", "Java", 26, 1, 9, 36
"c:\Users\Povilas.Grusas\OneDrive - Bentley Systems, Inc\Desktop\Bakis repo\voiceControlledRuleEditor\org.openhab.binding.voicecontrolledruleeditor\src\main\java\org\openhab\binding\voicecontrolledruleeditor\internal\utils\ConfigurationResult.java", "Java", 25, 0, 7, 32
"c:\Users\Povilas.Grusas\OneDrive - Bentley Systems, Inc\Desktop\Bakis repo\voiceControlledRuleEditor\org.openhab.binding.voicecontrolledruleeditor\src\main\java\org\openhab\binding\voicecontrolledruleeditor\internal\utils\ConfigurationUtils.java", "Java", 245, 14, 35, 294
"c:\Users\Povilas.Grusas\OneDrive - Bentley Systems, Inc\Desktop\Bakis repo\voiceControlledRuleEditor\org.openhab.binding.voicecontrolledruleeditor\src\main\java\org\openhab\binding\voicecontrolledruleeditor\internal\utils\ItemUtils.java", "Java", 41, 2, 13, 56
"c:\Users\Povilas.Grusas\OneDrive - Bentley Systems, Inc\Desktop\Bakis repo\voiceControlledRuleEditor\org.openhab.binding.voicecontrolledruleeditor\src\main\java\org\openhab\binding\voicecontrolledruleeditor\internal\utils\RuleManagerUtils.java", "Java", 25, 0, 9, 34
"c:\Users\Povilas.Grusas\OneDrive - Bentley Systems, Inc\Desktop\Bakis repo\voiceControlledRuleEditor\org.openhab.binding.voicecontrolledruleeditor\src\main\java\org\openhab\binding\voicecontrolledruleeditor\internal\utils\RuleRegistryUtils.java", "Java", 166, 1, 35, 202
"c:\Users\Povilas.Grusas\OneDrive - Bentley Systems, Inc\Desktop\Bakis repo\voiceControlledRuleEditor\org.openhab.binding.voicecontrolledruleeditor\src\main\java\org\openhab\binding\voicecontrolledruleeditor\internal\utils\StringUtils.java", "Java", 38, 0, 13, 51
"c:\Users\Povilas.Grusas\OneDrive - Bentley Systems, Inc\Desktop\Bakis repo\voiceControlledRuleEditor\org.openhab.binding.voicecontrolledruleeditor\src\main\java\org\openhab\binding\voicecontrolledruleeditor\internal\utils\ThingUtils.java", "Java", 21, 1, 7, 29
"c:\Users\Povilas.Grusas\OneDrive - Bentley Systems, Inc\Desktop\Bakis repo\voiceControlledRuleEditor\org.openhab.binding.voicecontrolledruleeditor\src\main\java\org\openhab\binding\voicecontrolledruleeditor\internal\utils\VoiceManagerUtils.java", "Java", 12, 0, 5, 17
"Total", "-", 2949, 167, 706, 3822