"filename", "language", "Java", "comment", "blank", "total"
"c:\Users\Povilas.Grusas\OneDrive - Bentley Systems, Inc\Desktop\Bakis repo\voiceControlledRuleEditor\org.openhab.binding.voicecontrolledruleeditor\src\main\java\org\openhab\binding\voicecontrolledruleeditor\internal\UserInformation.java", "Java", 28, 0, 10, 38
"c:\Users\Povilas.Grusas\OneDrive - Bentley Systems, Inc\Desktop\Bakis repo\voiceControlledRuleEditor\org.openhab.binding.voicecontrolledruleeditor\src\main\java\org\openhab\binding\voicecontrolledruleeditor\internal\VoiceControlledRuleEditorBindingConstants.java", "Java", 9, 20, 6, 35
"c:\Users\Povilas.Grusas\OneDrive - Bentley Systems, Inc\Desktop\Bakis repo\voiceControlledRuleEditor\org.openhab.binding.voicecontrolledruleeditor\src\main\java\org\openhab\binding\voicecontrolledruleeditor\internal\VoiceControlledRuleEditorConfiguration.java", "Java", 8, 20, 4, 32
"c:\Users\Povilas.Grusas\OneDrive - Bentley Systems, Inc\Desktop\Bakis repo\voiceControlledRuleEditor\org.openhab.binding.voicecontrolledruleeditor\src\main\java\org\openhab\binding\voicecontrolledruleeditor\internal\VoiceControlledRuleEditorHandler.java", "Java", 78, 49, 21, 148
"c:\Users\Povilas.Grusas\OneDrive - Bentley Systems, Inc\Desktop\Bakis repo\voiceControlledRuleEditor\org.openhab.binding.voicecontrolledruleeditor\src\main\java\org\openhab\binding\voicecontrolledruleeditor\internal\assistant\Instructions.java", "Java", 96, 0, 20, 116
"c:\Users\Povilas.Grusas\OneDrive - Bentley Systems, Inc\Desktop\Bakis repo\voiceControlledRuleEditor\org.openhab.binding.voicecontrolledruleeditor\src\main\java\org\openhab\binding\voicecontrolledruleeditor\internal\assistant\StatusReport.java", "Java", 51, 0, 17, 68
"c:\Users\Povilas.Grusas\OneDrive - Bentley Systems, Inc\Desktop\Bakis repo\voiceControlledRuleEditor\org.openhab.binding.voicecontrolledruleeditor\src\main\java\org\openhab\binding\voicecontrolledruleeditor\internal\commandHandlers\DefaultController.java", "Java", 31, 0, 10, 41
"c:\Users\Povilas.Grusas\OneDrive - Bentley Systems, Inc\Desktop\Bakis repo\voiceControlledRuleEditor\org.openhab.binding.voicecontrolledruleeditor\src\main\java\org\openhab\binding\voicecontrolledruleeditor\internal\commandHandlers\HandleCommandResult.java", "Java", 19, 0, 7, 26
"c:\Users\Povilas.Grusas\OneDrive - Bentley Systems, Inc\Desktop\Bakis repo\voiceControlledRuleEditor\org.openhab.binding.voicecontrolledruleeditor\src\main\java\org\openhab\binding\voicecontrolledruleeditor\internal\commandHandlers\ICommandHandler.java", "Java", 4, 0, 2, 6
"c:\Users\Povilas.Grusas\OneDrive - Bentley Systems, Inc\Desktop\Bakis repo\voiceControlledRuleEditor\org.openhab.binding.voicecontrolledruleeditor\src\main\java\org\openhab\binding\voicecontrolledruleeditor\internal\commandHandlers\RuleReaderController.java", "Java", 3, 0, 3, 6
"c:\Users\Povilas.Grusas\OneDrive - Bentley Systems, Inc\Desktop\Bakis repo\voiceControlledRuleEditor\org.openhab.binding.voicecontrolledruleeditor\src\main\java\org\openhab\binding\voicecontrolledruleeditor\internal\commandHandlers\UsersCommandHandler.java", "Java", 53, 0, 14, 67
"c:\Users\Povilas.Grusas\OneDrive - Bentley Systems, Inc\Desktop\Bakis repo\voiceControlledRuleEditor\org.openhab.binding.voicecontrolledruleeditor\src\main\java\org\openhab\binding\voicecontrolledruleeditor\internal\commandHandlers\ruleExternals\RuleAddingHandler.java", "Java", 102, 0, 31, 133
"c:\Users\Povilas.Grusas\OneDrive - Bentley Systems, Inc\Desktop\Bakis repo\voiceControlledRuleEditor\org.openhab.binding.voicecontrolledruleeditor\src\main\java\org\openhab\binding\voicecontrolledruleeditor\internal\commandHandlers\ruleExternals\RuleDeletingHandler.java", "Java", 9, 2, 4, 15
"c:\Users\Povilas.Grusas\OneDrive - Bentley Systems, Inc\Desktop\Bakis repo\voiceControlledRuleEditor\org.openhab.binding.voicecontrolledruleeditor\src\main\java\org\openhab\binding\voicecontrolledruleeditor\internal\commandHandlers\ruleExternals\RuleRenamingHandler.java", "Java", 96, 0, 26, 122
"c:\Users\Povilas.Grusas\OneDrive - Bentley Systems, Inc\Desktop\Bakis repo\voiceControlledRuleEditor\org.openhab.binding.voicecontrolledruleeditor\src\main\java\org\openhab\binding\voicecontrolledruleeditor\internal\commandHandlers\ruleInternals\AbstractModuleBuilder.java", "Java", 99, 2, 33, 134
"c:\Users\Povilas.Grusas\OneDrive - Bentley Systems, Inc\Desktop\Bakis repo\voiceControlledRuleEditor\org.openhab.binding.voicecontrolledruleeditor\src\main\java\org\openhab\binding\voicecontrolledruleeditor\internal\commandHandlers\ruleInternals\AvailableConfigurationType.java", "Java", 18, 0, 5, 23
"c:\Users\Povilas.Grusas\OneDrive - Bentley Systems, Inc\Desktop\Bakis repo\voiceControlledRuleEditor\org.openhab.binding.voicecontrolledruleeditor\src\main\java\org\openhab\binding\voicecontrolledruleeditor\internal\commandHandlers\ruleInternals\IBuilder.java", "Java", 14, 1, 10, 25
"c:\Users\Povilas.Grusas\OneDrive - Bentley Systems, Inc\Desktop\Bakis repo\voiceControlledRuleEditor\org.openhab.binding.voicecontrolledruleeditor\src\main\java\org\openhab\binding\voicecontrolledruleeditor\internal\commandHandlers\ruleInternals\RuleActionBuilder.java", "Java", 108, 3, 11, 122
"c:\Users\Povilas.Grusas\OneDrive - Bentley Systems, Inc\Desktop\Bakis repo\voiceControlledRuleEditor\org.openhab.binding.voicecontrolledruleeditor\src\main\java\org\openhab\binding\voicecontrolledruleeditor\internal\commandHandlers\ruleInternals\RuleConditionBuilder.java", "Java", 82, 0, 11, 93
"c:\Users\Povilas.Grusas\OneDrive - Bentley Systems, Inc\Desktop\Bakis repo\voiceControlledRuleEditor\org.openhab.binding.voicecontrolledruleeditor\src\main\java\org\openhab\binding\voicecontrolledruleeditor\internal\commandHandlers\ruleInternals\RuleEditingController.java", "Java", 307, 1, 73, 381
"c:\Users\Povilas.Grusas\OneDrive - Bentley Systems, Inc\Desktop\Bakis repo\voiceControlledRuleEditor\org.openhab.binding.voicecontrolledruleeditor\src\main\java\org\openhab\binding\voicecontrolledruleeditor\internal\commandHandlers\ruleInternals\RuleTriggerBuilderHandler.java", "Java", 110, 6, 10, 126
"c:\Users\Povilas.Grusas\OneDrive - Bentley Systems, Inc\Desktop\Bakis repo\voiceControlledRuleEditor\org.openhab.binding.voicecontrolledruleeditor\src\main\java\org\openhab\binding\voicecontrolledruleeditor\internal\commandHandlers\states\AbstractHandlerState.java", "Java", 30, 2, 10, 42
"c:\Users\Povilas.Grusas\OneDrive - Bentley Systems, Inc\Desktop\Bakis repo\voiceControlledRuleEditor\org.openhab.binding.voicecontrolledruleeditor\src\main\java\org\openhab\binding\voicecontrolledruleeditor\internal\commandHandlers\states\ruleAdd\RuleAddWaitingForEditConfirmation.java", "Java", 30, 0, 9, 39
"c:\Users\Povilas.Grusas\OneDrive - Bentley Systems, Inc\Desktop\Bakis repo\voiceControlledRuleEditor\org.openhab.binding.voicecontrolledruleeditor\src\main\java\org\openhab\binding\voicecontrolledruleeditor\internal\commandHandlers\states\ruleAdd\RuleAddWaitingForNameConfirmationState.java", "Java", 30, 0, 9, 39
"c:\Users\Povilas.Grusas\OneDrive - Bentley Systems, Inc\Desktop\Bakis repo\voiceControlledRuleEditor\org.openhab.binding.voicecontrolledruleeditor\src\main\java\org\openhab\binding\voicecontrolledruleeditor\internal\commandHandlers\states\ruleAdd\RuleAddWaitingForNameState.java", "Java", 30, 0, 9, 39
"c:\Users\Povilas.Grusas\OneDrive - Bentley Systems, Inc\Desktop\Bakis repo\voiceControlledRuleEditor\org.openhab.binding.voicecontrolledruleeditor\src\main\java\org\openhab\binding\voicecontrolledruleeditor\internal\commandHandlers\states\ruleEdit\RuleEditCreateModuleState.java", "Java", 30, 0, 9, 39
"c:\Users\Povilas.Grusas\OneDrive - Bentley Systems, Inc\Desktop\Bakis repo\voiceControlledRuleEditor\org.openhab.binding.voicecontrolledruleeditor\src\main\java\org\openhab\binding\voicecontrolledruleeditor\internal\commandHandlers\states\ruleEdit\RuleEditEditModuleState.java", "Java", 30, 0, 9, 39
"c:\Users\Povilas.Grusas\OneDrive - Bentley Systems, Inc\Desktop\Bakis repo\voiceControlledRuleEditor\org.openhab.binding.voicecontrolledruleeditor\src\main\java\org\openhab\binding\voicecontrolledruleeditor\internal\commandHandlers\states\ruleEdit\RuleEditRemoveModuleState.java", "Java", 30, 0, 9, 39
"c:\Users\Povilas.Grusas\OneDrive - Bentley Systems, Inc\Desktop\Bakis repo\voiceControlledRuleEditor\org.openhab.binding.voicecontrolledruleeditor\src\main\java\org\openhab\binding\voicecontrolledruleeditor\internal\commandHandlers\states\ruleEdit\RuleEditWaitingForEditTypeState.java", "Java", 30, 0, 9, 39
"c:\Users\Povilas.Grusas\OneDrive - Bentley Systems, Inc\Desktop\Bakis repo\voiceControlledRuleEditor\org.openhab.binding.voicecontrolledruleeditor\src\main\java\org\openhab\binding\voicecontrolledruleeditor\internal\commandHandlers\states\ruleEdit\RuleEditWaitingForNameState.java", "Java", 30, 0, 9, 39
"c:\Users\Povilas.Grusas\OneDrive - Bentley Systems, Inc\Desktop\Bakis repo\voiceControlledRuleEditor\org.openhab.binding.voicecontrolledruleeditor\src\main\java\org\openhab\binding\voicecontrolledruleeditor\internal\commandHandlers\states\ruleRename\RuleRenameWaitingForNameConfirmationState.java", "Java", 30, 0, 9, 39
"c:\Users\Povilas.Grusas\OneDrive - Bentley Systems, Inc\Desktop\Bakis repo\voiceControlledRuleEditor\org.openhab.binding.voicecontrolledruleeditor\src\main\java\org\openhab\binding\voicecontrolledruleeditor\internal\commandHandlers\states\ruleRename\RuleRenameWaitingForNewNameState.java", "Java", 30, 0, 9, 39
"c:\Users\Povilas.Grusas\OneDrive - Bentley Systems, Inc\Desktop\Bakis repo\voiceControlledRuleEditor\org.openhab.binding.voicecontrolledruleeditor\src\main\java\org\openhab\binding\voicecontrolledruleeditor\internal\commandHandlers\states\ruleRename\RuleRenameWaitingForOldNameState.java", "Java", 30, 0, 9, 39
"c:\Users\Povilas.Grusas\OneDrive - Bentley Systems, Inc\Desktop\Bakis repo\voiceControlledRuleEditor\org.openhab.binding.voicecontrolledruleeditor\src\main\java\org\openhab\binding\voicecontrolledruleeditor\internal\constants\Enums.java", "Java", 164, 0, 27, 191
"c:\Users\Povilas.Grusas\OneDrive - Bentley Systems, Inc\Desktop\Bakis repo\voiceControlledRuleEditor\org.openhab.binding.voicecontrolledruleeditor\src\main\java\org\openhab\binding\voicecontrolledruleeditor\internal\constants\ModuleTypes.java", "Java", 12, 0, 2, 14
"c:\Users\Povilas.Grusas\OneDrive - Bentley Systems, Inc\Desktop\Bakis repo\voiceControlledRuleEditor\org.openhab.binding.voicecontrolledruleeditor\src\main\java\org\openhab\binding\voicecontrolledruleeditor\internal\constants\TTSConstants.java", "Java", 60, 2, 10, 72
"c:\Users\Povilas.Grusas\OneDrive - Bentley Systems, Inc\Desktop\Bakis repo\voiceControlledRuleEditor\org.openhab.binding.voicecontrolledruleeditor\src\main\java\org\openhab\binding\voicecontrolledruleeditor\internal\constants\UserInputs.java", "Java", 104, 18, 20, 142
"c:\Users\Povilas.Grusas\OneDrive - Bentley Systems, Inc\Desktop\Bakis repo\voiceControlledRuleEditor\org.openhab.binding.voicecontrolledruleeditor\src\main\java\org\openhab\binding\voicecontrolledruleeditor\internal\factory\VoiceControlledRuleEditorHandlerFactory.java", "Java", 52, 18, 11, 81
"c:\Users\Povilas.Grusas\OneDrive - Bentley Systems, Inc\Desktop\Bakis repo\voiceControlledRuleEditor\org.openhab.binding.voicecontrolledruleeditor\src\main\java\org\openhab\binding\voicecontrolledruleeditor\internal\utils\AudioManagerUtils.java", "Java", 26, 1, 9, 36
"c:\Users\Povilas.Grusas\OneDrive - Bentley Systems, Inc\Desktop\Bakis repo\voiceControlledRuleEditor\org.openhab.binding.voicecontrolledruleeditor\src\main\java\org\openhab\binding\voicecontrolledruleeditor\internal\utils\ConfigurationResult.java", "Java", 25, 0, 7, 32
"c:\Users\Povilas.Grusas\OneDrive - Bentley Systems, Inc\Desktop\Bakis repo\voiceControlledRuleEditor\org.openhab.binding.voicecontrolledruleeditor\src\main\java\org\openhab\binding\voicecontrolledruleeditor\internal\utils\ConfigurationUtils.java", "Java", 245, 14, 35, 294
"c:\Users\Povilas.Grusas\OneDrive - Bentley Systems, Inc\Desktop\Bakis repo\voiceControlledRuleEditor\org.openhab.binding.voicecontrolledruleeditor\src\main\java\org\openhab\binding\voicecontrolledruleeditor\internal\utils\ItemUtils.java", "Java", 41, 2, 13, 56
"c:\Users\Povilas.Grusas\OneDrive - Bentley Systems, Inc\Desktop\Bakis repo\voiceControlledRuleEditor\org.openhab.binding.voicecontrolledruleeditor\src\main\java\org\openhab\binding\voicecontrolledruleeditor\internal\utils\RuleRegistryUtils.java", "Java", 157, 0, 33, 190
"c:\Users\Povilas.Grusas\OneDrive - Bentley Systems, Inc\Desktop\Bakis repo\voiceControlledRuleEditor\org.openhab.binding.voicecontrolledruleeditor\src\main\java\org\openhab\binding\voicecontrolledruleeditor\internal\utils\StringUtils.java", "Java", 38, 0, 13, 51
"c:\Users\Povilas.Grusas\OneDrive - Bentley Systems, Inc\Desktop\Bakis repo\voiceControlledRuleEditor\org.openhab.binding.voicecontrolledruleeditor\src\main\java\org\openhab\binding\voicecontrolledruleeditor\internal\utils\ThingUtils.java", "Java", 21, 1, 7, 29
"c:\Users\Povilas.Grusas\OneDrive - Bentley Systems, Inc\Desktop\Bakis repo\voiceControlledRuleEditor\org.openhab.binding.voicecontrolledruleeditor\src\main\java\org\openhab\binding\voicecontrolledruleeditor\internal\utils\VoiceManagerUtils.java", "Java", 12, 0, 5, 17
"Total", "-", 2642, 162, 629, 3433